'ie	i
'k	@k
'm	@m
'r	@r
't	@t
d'r	d@r
daar	dar
eens	@s
een	@n
er	@r
haar	@r
hem	@m
hen	hYn
het	@t
hij	hK
hun	hYn
ie	i
ik	@k
je	j@
m'n	m@
me	m@
mijn	m@n
we	w@
z'n	z@n
ze	z@
zij	zK
met	mEt
in	In
op	Op
van	vAn
uit	Kt
over	'o-v@r
onder	'On-d@r
achter	'Ax-t@r
voor	vOr